1111111111111111111111111111111111111111
10E0000000000000000000000000000000000001
1000C000C000C0001000C000C000C000C000C001
10000000000000001000000C0000000000000001
100000000000000010C0000100C0010000000001
1000000010000000000000000000000000000001
100000001000C0100010000C0100000100000001
1000000010000000000000000100000010000001
1000000000000001000C00000000000000000001
10P00000C00000000100000C0000000000000001
1111111111111111111111111111111111111111