111111111111111111111111111111111111111111111111111
1C000000100000100C0C00000001000010000000C0000000001
1P000100000000000C001C00C000100010010000000C0000001
100C0011111111110000100000100100100000000C000000001
10000010C000C00100C010000010010010011000000000C0001
100010111100111100001000001001001001111111111100C01
10001000010011111111100000100100100110000000000C001
1C001C0001000C000000000C0010010011110000C00000C0001
10001000010000000111111000000100000000000000C000001
111111111111111111111111111111111111111111111111111