11111111111111111111111111111111111111111111111111111111111
11000000000000000000000000000000000000000000000001100000001
11100000000000000000000000000000000000000000000000100100001
10100000000000000000000000000000000000000000000001110101011
11000000000000000000000000000000000000000000000001100000001
11100000000000000000000000000000000000000000000000100100001
10100000000000000000000000000000000000000000000001110101011
11000000000000000000000000000000000000000000000001100000001
11100000000000000000000000000000000000000000000000100100001
10100000000000000000000000000000000000000000000001110101011
11000000000000000000000000000000000000000000000001100000001
11100000000000000000000000000P00000000000000000000100100001
101C0000000000000000000000000000000000000000000001110101011
11000000000000000000000000000000000000000000000000011000001
11100000000000000000000000000000000000000000000000100100001
101C0000000000000000000000000000000000000000000001110101011
10000000C000000000000000000000C000000E000000000001000000001
11111111111111111111111111111111111111111111111111111111111