1111111111111111111111111111111111111111111111111
1000010010100000101000001010000010100000101000001
1000010001000000010000000100000001000000010000001
1000010010100000101000001010000010100000101000001
1000010001000000010000000100000001000000010000001
1000010010100000101000001010000010100000101000001
1000010001000000010000000100000001000000010000001
1000010010100001010000001010000010100000101000001
10000100010000000100000001000P0001000000010000001
1000010010100000101000001010000010100000101000001
1000010001000000010000000111111111000000010000001
1110E0C000000000000000000000000000000000000000001
1010000100010001000100010001000100010001000100001
1001101111000101110001011100010111000101110001001
1111111111111111111111111111111111111111111111111