11111111111111111111111111111111111111111111111111111111111
11000000000000000000000000000000000000000000000001100000001
111001010010000000100C001000010000C100100000001010100100001
10100100101010101010101C01110101010101111111111111110101011
11000000000000000000000000C00000C00000000000000001100000001
11100101001000000010000010000100000100100000001010100100001
1010010010101010101010100111010101C101111111111111110101011
110000C0000000000000000000000000000000000000000001100000001
1110010100100000001000001000010000010C100000001010100100001
10100100101010101010101001110101010101111111111111110101011
11000000000000000000000000000000000000000000000001100000001
1110010100100000001C000010000100000100100000001010100100001
101C0100101010101010101001110101010101111111111111110101011
11000000000000000000000000000000000000000000000001100000001
111001010C100000001000C010000100000100100000001010100100001
101C0100101010101010101001110101010101111111111111110101011
10000000C0000000000000000000000P000000E00000000000100000001
11111111111111111111111111111111111111111111111111111111111