111111111111111111111111111111111111111111111111111
100001001010001000000000000100001000000010000100001
100001000100010000001000000010001001000010000100001
111000000000000000001000001001001001000010000100001
101000010001000100001001001000000001100011111100001
101011111100111100001010101101001001111111111101001
1010100C0100111111111001001011001001100011111110111
1E1110000100000000000000000111001111000010000P00001
100010000100000001111110001111000000000010000000001
111111111111111111111111111111111111111111111111111