111111111111111111111111111111111111111111111111111
1P0000000000000000000000000000000000000000000000001
101000011110011110011111011111000100011000110111111
1010000100000100000001000100000010100101C1010100001
101000011110011110000100010111010001010010010111111
101000010000010000000100010001011111010000010100001
101111011110011110000100011111011E11010000010111111
100000000000000000000000000000000000000000000000001
111111111111111111111111111111111111111111111111111