1111111111111111111111111111111111
1100000000000000P0000E000000000011
1110010100100000101001000000010101
1010010010101010001011111111111111
1000000000000000000000000000000001
1111111111111111111111111111111111