1111111111111111111111111111111111
110000000000000000000E000000000011
1110010100100000101001000000010101
1010010010101010001011111111111111
1000000P00000000000000000000000001
1111111111111111111111111111111111